NO ./texture/wall_y.xpm
SO ./texture/wall_y.xpm
WE ./texture/wall_x.xpm
EA                    ./texture/wall_x.xpm
FL ./texture/floor.xpm
CE ./texture/ceilergegregering.xpm

11111111111111111111111111111111111111111111111111111
1       100000000011000000000000000000000000000000001
1       101100000111000000000000000000010000000000001
1       101100000111000000000100000000000000000000001
1       101100000111000000000000000000000000000000001
1       101100000111000000010000000000000001000000001
1       101100000111000000000000000000000000000000001
1       101100000111000000000000000000000000000000001
1       101100000111000000000000000100000000000000001
1       101100000111000000000000000000000000100000001
1       101100000111000000010000000000000000000000001
1       101100000111000000000000000000000000000000001
1       101100000111000000000000000100000000000000001
1       101100000111000000000000000000000010000000001
1       101100000111000000001000000000000000000000001
1       101100000111000000000000000000000000000000001
1       100100000000000000000000000000100000000100001
11111111101100000111000000000000000000000000000000001
10000000001100000111011111111111111111111111111111111
11110111111111011100000000001
11110111111111011101010010001
11000000110101011100000010001
10000000000000001100000010001
10000000000000001101010010001
11000001110101001111011110S0111
11110111 1110101 101111010001
11111111 1111111 111111111111
11111111111111111                                        111111111111
