NO ./texture/wall_y.xpm
SO ./texture/wall_y.xpm
WE ./texture/wall_x.xpm
EA                    ./texture/wall_x.xpm
FL ./texture/floor.xpm
CE ./texture/ceiling.xpm
              

11111111111111111111111
10000000000000000000001
10000000S00000000000001
10000000000000000000001
10000000000000000000001
10000000.00000000000001
10000000000000000000001
10000000000000000000001
11111111111111111111111
