NO ./texture/wall_y.xpm
SO ./texture/wall_y.xpm
WE ./texture/wall_x.xpm
EA                    ./texture/wall_x.xpm
FL ./texture/floor.xpm
CE ./texture/ceiling.xpm
              

11111111111111111111111
10000000000000000000001
1,00vvvvWvv000000000001
1000000000000.0000000,1
10000.00000000000000001
10000000000000000000001
1,0000000zxcv00000000,1
10000000000000000000001
11111111111111111111111
