NO ./texture/wall_y.xpm
SO ./texture/wall_y.xpm
WE ./texture/wall_x.xpm
EA                    ./texture/wall_x.xpm
FL ./texture/floor.xpm
CE ./texture/ceiling.xpm
              

11111111111111111111111
10000000000000000000001
1000vvvvfW0v000000000001
10000000000000000000001
10000000000000000000001
1000000000000,,.0000001
100000000zx0v0000000001
1000000000000000000001
11111111111111111111111
