NO ./texture/wall_y.xpm
SO ./texture/wall_y.xpm
WE ./texture/wall_x.xpm
EA                    ./texture/wall_x.xpm
FL ./texture/floor.xpm
CE ./texture/ceiling.xpm
              

11111111111111111111111111111111111111111111111111111
1       100000000011000100000001110000010000000000001
1       101100000111000100000001110000010000000000001
1       10110000011100110000010111111D111111111111D11
1       10110000011100000010000D000010000000000000001
1       101100000111111D11111111110010000001000000001
1       1011000001110000000000011100000111111111111D1
1       101101111111000000000001110000010000000000001
1       101100000111000111111111110100010000000000001
1       1011000001110001000000011100000111111D1000001
1       1011111D1111000110010001110000000001001000001
1       1011000001110000111111D1110000000001001000001
1       101100000111000000000101110100000010001000001
1       101110001110000000011011111111000100011111101
1       10110001111100100000D001110000000000000000001
1       1011000001111111111111111101111111111111D1111
1       100100000000001111D10001000000111000011100001
11111111101100000111000000001000001110000001F10000001
10000000001100000111011111D11111111111111111111111111
1111D111111111D111000000D000D00000000001
1111011111111101110101001000111111111111
1100001011010101110000001010101
100000D0000100000110000001F01011
100000100000000011010101001S00F1
11000001110101001111011110111011
11110111 1110101 10111101010101
11111111 1111111 11111111111111
11111111111111111                                        111111111111
