NO ./texture/wall_y.xpm
SO ./texture/wall_y.xpm
WE ./texture/wall_x.xpm
EA                    ./texture/wall_x.xpm
FL ./texture/floor.xpm
CE ./texture/ceiling.xpm
              

1111111111111111111111111111111111111111111111
10000000000000000000000000000000000000N1111111
1111111111111111111111111111111111111111111111
