NO ./texture/wall_y.xpm
SO ./texture/wall_y.xpm
WE ./texture/wall_x.xpm
EA                    ./texture/wall_x.xpm
FL ./texture/floor.xpm
CE ./texture/ceiling.xpm
              

1111111111111111111111111111111111111111111
00000000000000000000000000000000000001E.001
1111111111111111111111111111111111111111111
