NO ./texture/wall_y.xpm
SO ./texture/wall_y.xpm
WE ./texture/wall_x.xpm
EA ./texture/wall_x.xpm
FL ./texture/floor.xpm
CE ./texture/ceiling.xpm


                                                                                           
                                                                                     111111      
                                                                                    1    ,1
                                                 111111111111111111111111111111111111 1111111111111                                                                111111111111111111111111111111111111111
                                                 1,           1     1                             ,1                                                               1                                     1
                                                1            1  1111                               1                                                               1     1111 <   1111    1111111111     1
                        .                      11  1   1     1 1        111111111111111 1 11111111x1                                                               1 <   1111     1111     1111111111    1
                                             11 <1  1   1      11       1               1        1F1                                                               1     1111     1111            1111   1
                                            1F      1  111111   1      1111             1        111                                                               1     1111     1111     <       1111  1
                                            1111111111    ,   1  1  111         111111111       1                                                                  1     1111   . 1111            1111   1
                                                     1   11   1   1   1   1 1   1        1       1                                                                 1     1111111111111         111111    1
                                                     1   1    1   1   1 111111  1c..     1      1                                                                  1     1111111111111  f    11111111    1
                                           111       1   1    1    11 1 1        1       1     ,1                                                                  1     1111111111111     11111111      1
                                        111 S 111     1            11   1         1     1     111111111111111111111111111                                          1              1111     1111          1
                                      11         11    1       1   11 11111        1   1                             c ,1                                          1  <           1111 <   1111        . 1
                                     1    z 1 x    1    1       1                  1   1                   x            1                                          1              1111     11111111111   1
                                     1   1111111   1    11D111  1111111  11111     1  1           1                     1111              111                      1              1111     11111111111   1
                                     1    11111    1    1         ,1  1  1zvz1     1  1    11                               1            1   11                    1        <     1111                   1
                                      11    ,    11     1          1  1  1zxz1     D  11111          v                 11111          111  c   1                   1 1            1111      <        .   1
                                        111   111   11111          1  1  11F11     1                      11111111     11           11          111                1 1.                                  1
                                           1D1     1            1 11  1   111      1             1                      111        1 c    .        11 1            1F1111111111111111111111111111111111111
                                           1 1    1c   1       1   1  1            1          111          11              1      1                  1c1111111111   1
                                           1 1    1    1       1   1  1            1          1   1       1               1       1                11          1F1
                                           1 1    1    1       1   1  1            1         111   1     11             111      1    .    z   .  1      .     1  1
                                        1111 1111111111      11     11            1        111      1   1                 1     1                    1111 11      1
                                       1             D     1D1        1       111       11     1    1  1    1             1      1 c          1111       .        1
                                1     11   111       1     1        1                               1D11,                 ,1     111  c        1  1  1111111111111
                               1 11111 1         11111111111111111111111111111D1       111                                1        1         1           .1
                               1                11      11      1      1        11111111                                11111       1          1    11111111
                              1      1111   111       11        1       1                1         x                v   1c   1       11    .    1    1
                              1   111      1         1           11            1                                        1111 111111111           1111
                             1  11         1        1             111            1                                             F1F      z            1
                              11            1      1                 1       1                   111111111111111111111111111111111111111111111 111111
                              1F. 1 1  1 1111111111                   1F1  1    11     11         1                                          1F1  1  1111
                               11  1       1                           1   1111          1      111                                          111 1       111
                                1  1  111111                           1  1         11111      1                                             1F11     ,     11                               
                                1     1                                1   1         1      1111                                          111                 111                                     
                                 111111                                 1      1111111   111F11                                 1    11111   ,       v       ,   1                                           
                                                                      11        1       1      1                               1c1111                             1       
                                                                    11           11D1111        1                              1 1                          1      1       
                                                                    1      >         11     x    1                            1         ,        ,        1111      1
                                                                    1           z    11           111111111                   1   ,                         1     , 1
                                                                   1      >         1111        >        ,11                   1                      111111111     1              
                                                                    1                D                     1                   11                    1      v 1     1
                                                                     11   x        111         11111111   11                     1     ,    v              1111     1             
                                                                       111      111     >        1         1                      1               ,      11 ,      1                          
                                                                          11   11             1111      1111                       11                 111      , 11
                                                                            111,          x       1z 1111                            111            11        111     
                                                                               1                  11111                                11   ,      1 ,     1111        
                                                                                1    >    1   1111                                       1111    11   v1111 
                                                                                 1      1111   c1                                            1111111111              
                                                                                  111111   1 >  11                                                     
                                                                                           1  .1                                             
                                                                                            1111                                                         
