NO ./texture/wall_y.xpm
SO ./texture/wall_y.xpm
WE ./texture/wall_x.xpm
EA                    ./texture/wall_x.xpm
FL ./texture/floor.xpm
CE ./texture/ceiling.xpm
              

11111111111111111111111
10000000000000000000001
1000vvvvf00v00000000001
1000...00000000.0000001
10000000.00000..0000001
1000.000000000,,.000001
100000000zx0v0000000001
100000000000000000000W1
1111111111111111111111
