NO ./texture/wall_y.xpm
SO ./texture/wall_y.xpm
WE ./texture/wall_x.xpm
EA                    ./texture/wall_x.xpm
FL ./texture/floor.xpm
CE ./texture/ceiling.xpm
              

11111111111111111111111
1000100000000000D000001
1001E100000000001000001
10001000000000000000001
10000000000000000000010111111
10000000000000000000100000001
10000000000000000000100010001
100000000000000000001000.0001
10000000000000000000100000001
11111111111111111111111111111
