NO ./texture/wall_y.xpm
SO ./texture/wall_y.xpm
WE ./texture/wall_x.xpm
EA                    ./texture/wall_x.xpm
FL ./texture/floor.xpm
CE ./texture/ceiling.xpm

1111111111111111111111111111111111111111111
1000000010000001F100000000000000010000000F1
1000000010000000000000000000000001011111111
100011111000000000000000000000000100000001
100000001000000000000000000000000111111101
101110001000000000000000000000000100000001
100000001000000000000000000000000100111111
10011100F1000000000000000000000000100000001
100000001000000000000000000000000111111011
100000111000000000000000000000000100000001
100000001000000000000000000000000000000001
101110001110000000000000000000000000000011
10000000D00000000000000000000000000000011
111111F1111D11D11111111111111111111111111111111111111111111
111111111000000000011000000000000000100000001010000000000011
1000001000000000000000000000000000001000000010010000000000001
100000D00000000000000000011100000000D0000000D00D000000000000F1
10000010000000000011000000000000000110000001111111111111111111
10011111111111111100000000000000001111111111111
1D100000000000000000001111111111111
10000000000000000000001
11111111111111111110001
 1000001000000000000001                 1111
 1000001000000000000001                 1F1
 100000D00000000000001                  101
100000010000000000111             11111111111111111111111111111111111
11110001000000000111              10000000000000000000000000000000001
1F111111D1111111D1                100000000000000000000000000000000001
100000000000000001                100000000000000000000000000000000001
 11000000011100001                100000000000000000000000000000000001
 1100000000W000001                100000000000000000000000000000000001            
 11000111000000001                111111111111111111111111111111111111
 110000000000001F1
111111111111111111                  11111111111111111111111111111111
                                    1F110100000010010000010010000101
                                    10010101111D10011111D10111D10101
                                    10010100000100000010000000000101
                                    10011111110111111011111111110101
                                    10000000010000001000000000010001
                                    11111110010111101011111110011101
                                    100000100D0000100000000000000101
                                    10111D10011110101111110011110101
                                    101000100000101000000100000101F1
                                    11111111111111111111111111111111
