NO ./texture/wall_y.xpm
SO ./texture/wall_y.xpm
WE ./texture/wall_x.xpm
EA                    ./texture/wall_x.xpm

FL ./texture/floor.xpm
CE ./texture/ceiling.xpm

11111111111111111111
1   1     1       F1
1 1 1 111 1 11111111
1 1     1        1 1
1 11111 11111111D1 1
1     1            1
11111 111 111 1111 1
1         1      1 1
1 111111111 1111 D 1
1   1F         1 1 1
111 111 111111 1 1 1
1   1      W 1   1 1
1 111 111111 11111 1
1     1            1
11111D1 1111111 1111
1F            1    1
1111111111111 1111 1
1                  1
1                11111111111111
1    1         1        1    F1
1 11 1 1111 11 1 11111  1 11 1 1
1  1 1      1  1     1  1    1 1
1  1 1 1111D1  11111D1 11111 1 1
1  1 1     1      1          1 1
1  1111111 111111 1111111111 1 1
1        1      1          1   1
1111111  1 1111 1 1111111  111 1
1     1  1    1 1       1    1 1
1 111D1  1111 1 111111  1111 1 1
1 1   1     1 1      1     1 1 1
1 1 111111  1 11111  11111 1 1 1
1 1      1  1     1      1 1   1
1 11111  11 1111  111111 1 11111
1     1                 1      1
11111 1111111111111111  111111 1
1F               1           1 1
1111111111111111 1 111111111 1 1
1 1            1 1 1       1 1 1
1 1 111111111  1 D 1 1111  1 1 1
1 1         1  1 1 1 1     1   1
1 11111111  11 111 1 11111 11111
1        1       1 1           1
1111111  1111111 1 11111111111 1
1     1        1 1           1 1
1 111 11111111 1 11111111111 1 1
1 1 1        1 1           1 1 1
1 1 11111111 1 1111111111  1 1 1
1 1        1 1          1  1   1
1 11111111 1 111111111  1  11111
1        1 1         1  1      1
1111111  1 111111111 1  111111 1
1     1  1         1 1       1 1
1 111D1  1111111 1 1 1111111 1 1
1 1   1        1 1 1       1 1 1
1 1 111111111  1 1 111111  1 1 1
1 1         1    1      1  1   1
1 11111111  1111111111  1  11111
1        1           1  1      F1
11111111111111111111111111111111
