NO ./texture/north.xpm
SO ./texture/south.xpm
WE ./texture/west.xpm
EA ./texture/east.xpm

F 184,113,39
C 51,153,255

11111111111111111111111111111111
10000000000000000000000000000001
10000000000000000000000000000001
10000000001111111110000000000001
10000000001000000010000000000001
10000000001000000010000000000001
10000000001000W00010000000000001
10000000001000000010000000000001
10000000001111101110000000000001
10000000000000101000000000000001
10000000000000101000000000000001
10000000000000101000000000000001
10000000000000000000000000000001
10000000000000000000000000000001
11111111111111111111111111111111
