NO ./texture/wall_y.xpm
SO ./texture/wall_y.xpm
WE ./texture/wall_x.xpm
EA                    ./texture/wall_x.xpm

FL ./texture/floor.xpm
CE ./texture/ceiling.xpm

11111111111111111111111111111111
10000000000000000000000000000001
10011111111111111111111111111101
10010000001111111110000000001001
10010000001000000010000000001001
10010000001000000010000000001001
10010000001000W00010000000001001
10010000001000000010000000001001
10010000001111101110000000001001
10010000000000101000000000001001
10010000000000101000000000001001
10010000000000101000000000001001
10011111111111100000000000001001
10000000000000000000000000000001
11111111111111111111111111111111
