NO ./texture/wall_y.xpm
SO ./texture/wall_y.xpm
WE ./texture/wall_x.xpm
EA                    ./texture/wall_x.xpm

FL ./texture/floor.xpm
CE ./texture/ceiling.xpm

11111111111111111111
100010000010000000F1
10101011101011111111
10100000100000000101
1011111011111111D101
10000010000000000001
11111011101110111101
10000000001000000101
10111111111011110D01
10001F00000000010101
11101110111111010101
10001000000W01000101
10111011111101111101
10000010000000000001
11111D10111111101111
1F000000000000100001
11111111111110111101
10000000000000000001
1000000000000000011111111111111
10000100000000010000000010000F1
10110101111011010111110010110101
10010100000010010000010010000101
10010101111D10011111D10111110101
10010100000100000010000000000101
10011111110111111011111111110101
10000000010000001000000000010001
11111110010111101011111110011101
10000010010000101000000010000101
10111D10011110101111110011110101
10100010000010100000010000010101
10101111110010111110011111010101
10100000010010000010000001010001
10111110011011110011111101011111
10000010000000000000000010000001
11111011111111111111110011111101
1F000000000000000100000000000101
11111111111111110101111111110101
10100000000000010101000000010101
10101111111110010D01011110010101
10100000000010010101010000010001
10111111110011011101011111011111
10000000010000000101000000000001
11111110011111110101111111111101
10000010000000010100000000000101
10111011111111010111111111110101
10101000000001010000000000010101
10101111111101011111111110010101
10100000000101000000000010010001
10111111110101111111110010011111
10000000010100000000010010000001
11111110010111111111010011111101
10000010010000000001010000000101
10111D10011111110101011111110101
10100010000000010101000000010101
10101111111110010101111110010101
10100000000010000100000010010001
10111111110011111111110010011111
1000000001000000000001001000000F1
11111111111111111111111111111111
