NO ./texture/north.xpm
SO ./texture/south.xpm
WE ./texture/west.xpm
EA ./texture/east.xpm

F 220,100,0
C 225,30,0

1111011
1000001
10N0001
1000001
1111111
